1111111111
1000110001
1000000111
1000000001
1000312101
1000010111
1111111112