1111111111
1000110001
1000000111
1000000001
1000X11101
1000010101
1111111111
