1111111111
2000110001
1000000111
1000000001
1000312101
1000010111
1111111112