1111111111111111111111111111111111111
1111111111111111111111111111111111111
1111111111111111111111111111111111111
1111111111111111111111111111111111111
1111111111111111111111111111111111111
1111111111111111111111111111111111111
1111111100000000000000000000000000011
1111111000000000000000000000000000011
1111110000000000000000000000011100011
1111111111111100011110000000011100011
1111111100000000011110000000011100011
1110000000111000011110000000011100011
1110000000000000011110000000011100011
1100000111111000000300001100011100011
1110000100000000000000011100011100011
1111011100011111111000000111111000011
1111000100011111111000000000000000001
1111100100000000000000001111110000001
1111110000001100110011001111111111111
1111111111111111111111111111111111111
1111111111111111111111111111111111111
1111111111111111111111111111111111111
