11111111111111111111111111111111111
11111110000000000000000000000000001
11111100000000000000000000000000001
11111000000000000000000000001110001
11111111111110001111000000001110001
11111110000000001111000000001110001
11000000011100001111000000001110001
11000000000000001111000000001110001
10000011111100000030000110001110001
11000010000000000000001110001110001
11101110001111111100000011111100001
11100010001111111100000000000000000
11110010000000000000000111111000000
11111000000110011001100111111111111
11111111111111111111111111111111111
