11111111
10000001
10000001
10100101
10000001
10200101
10000001
10300101
10000001
10000001
11111111
