111111
100001
100001
112211
103001
100001
100001
111111
