11111111111111111111
10000000000000000001
10000000000000006001
10000000000000000001
10111111110111111101
10100000000000000101
10106000000000000101
10100000000000000101
10100000000000000101
10100000000000000101
10100000000000000101
10000000020000000001
10100000000000000101
10100000000000000101
10100000000000000101
10100000000000000101
10100000000000000101
10100000000000000101
10100000000000000101
10111111110111111101
10000000000000000001
10060000000000006001
10000000000000000001
11111111111111111111
