1111111111111111111111
1000000000000000000001
1000060000000000600001
1000000000000000000001
1011111111111111111101
1010000000000000000101
1010000000000000000101
1010000000000000000101
1010000000000000000101
1010000000000000000101
1010000000000000000101
1000000002000000000001
1010000000000000000101
1010000000000000000101
1010000000000000000101
1010000000000000000101
1010000000000000000101
1010000000000000000101
1010000000000000000101
1010000000000000000101
1010000000000000000101
1010000000000000000101
1010000000000000000101
1011111110000111111101
1001111110000111111001
1060111110000111110601
1000111110000111110001
1000111110000111110001
1000000000660000000001
1111111111111111111111
