1111111111111111111111
1000000000000000000001
1000060000000000600001
1000000000000000000001
1011111111111111111101
1010000000000000000101
1010000000000000000101
1010000000000000000101
1010000000000000000101
1010000000000000000101
1010000000000000000101
1000000002000000000001
1010000000000000000101
1010000000000000000101
1010000000000000000101
1010000000000000000101
1010000000000000000101
1010000000000000000101
1010000000000000000101
1010000000000000000101
1010000000000000000101
1010000000000000000101
1010000000000000000101
1011111110000111111101
1000000010000100000001
1000006010000106000001
1000000010000100000001
1000000010000100000001
1000000000600000000001
1111111111111111111111
