111111111
100000001
100000000
100000001
111111111
