111111111
100000001
100000001
100000000001
111111111
