111111111111111111111111111111
100110000011000000000140010041
100011000110000000000410140001
100001100000000000000000000001
100011000001111111111110111111
100000000000000411111400000001
100000000001112111111101011101
100000000001000001000101000001
100000000001003001000101011111
100004000001000001000100000002
100000000001110111000111111101
100000000000000000000000000001
101100110001100011001100110001
101100110001100011001100110101
100000000000000000000000010101
111111111111111111111111111111
