111111111111111111111111111111
100000000000000000000000000101
100000000000000111111111111001
100000000000000000000000000011
100000000011111111111101110111
100000000000000000010000100001
100000000001110111111101111001
100000000001000001000001000001
10000000000100X000010101001101
100000000001000001100101101001
100000000001110111000100101111
100000000000000000000111100001
100000000000000000000000000001
100000000000000000000000000001
100000000000000000000000000001
111111111111111111111111111111
