11111111111111111111111111111111
10000000000000001000000000000001
10000000111111111000000111111111
10040000000000011000000110000001
10000001100000011000000110000001
10000001100000000000000000090001
10000000000000011000000000000001
11100000000000011110000000000001
11000000000000011100000000000001
10000008000001111000000900001111
10000000000000000000000000000001
10000008000000011000000000000001
10000000000000011000000000000001
10000000000001111111100000001111
10000000000000000000000000000001
11100111100001111111100001111111
11110111100000011111100000000001
10000000000000010000000000000011
10000000111111111000000011001111
10000000000000011000000011000001
10007001100000011007070011000001
10000001100000011000000011000001
10000000000000011000000000000001
11100000000000011110000000000001
11000000000000011100000000000001
10000000000001111000000000000110
10000011000000000000000000000001
10000011000000000000002000000001
10000000000000011000000000000001
10000000000000011000000000001111
10080000000000011000000000000001
11111111111111111111111111111111
