11111111
10000001
11000111
11000111
11000111
11000111
11000111
11000111
11000111
11000111
11000111
11000111
11000111
11000111
11000111
11000111
11000111
11000111
11000111
11000111
11000111
11000111
11000111
11000111
11000111
11000111
11000111
11000111
11000111
11000111
11000111
11000111
11000111
11000111
11000111
11000111
11000111
11000111
11000111
11000111
11000111
11000111
11000111
11000111
11000111
11000111
11000111
11000111
11000111
11000111
11000111
11000111
11000111
11000111
11000111
11000111
11000111
11000111
11000111
11000111
11000111
11000111
11000111
11000111
11000111
11000111
11000111
11000111
11000111
11000111
11000111
11000111
11000111
11000111
11000111
11000111
11000111
11000111
11000111
11000111
11000111
11000111
11000111
11000111
11000111
11000111
11000111
11000111
11000111
11000111
11000111
11000111
11000111
11000111
11000111
11000111
11000111
11000111
11000111
11000111
11000111
11000111
11000111
11000111
11000111
11000111
11000111
11000111
11000111
11000111
11000111
11000111
11000111
11000111
11000111
11000111
11000111
11000111
11000111
11000111
11000111
11000111
11000111
11000111
11000111
11000111
11000111
11000111
11000111
11000111
11000111
11000111
11000111
11000111
11000111
11000111
11000111
11000111
11000111
11000111
11000111
11000111
11000111
11000111
11000111
11000111
11000111
11000111
11000111
11000111
11000111
11000111
11000111
11000111
11000111
11000111
11000111
11000111
11000111
11000111
11000111
11000111
11000111
11000111
11000111
11000111
11000111
11000111
11000111
11000111
11000111
11000111
11000111
11000111
11000111
11000111
11000111
11000111
11000111
11000111
11000111
11000111
11000111
11000111
11000111
11000111
11000111
11000111
11000111
11000111
11000111
11000111
11000111
11000111
11000111
11000111
11000111
11000111
11000111
11000111
11000111
11000111
11000111
11000111
11000111
11000111
11000111
11000111
11000111
11000111
11000111
11000111
11000111
11000111
11000111
11000111
11000111
11000111
11000111
11000111
11000111
11000111
11000111
11000111
11000111
11000111
11000111
11000111
11000111
11000111
11000111
11000111
11000111
11000111
11000111
11000111
11000111
11000111
11000111
11000111
11000111
11000111
11000111
11000111
11000111
11000111
11000111
11000111
11000111
11000111
11000111
11000111
11000111
11000111
11000111
11000111
11000111
11000111
11000111
11000111
11000111
11000111
11000111
11000111
11000111
11000111
11000111
11000111
11000111
11000111
11000111
11000111
11000111
11000111
11000111
11000111
11000111
11000111
11000111
11000111
11000111
11000111
11000111
11000111
11000111
11000111
11000111
11000111
11000111
11000111
11000111
11000111
11000111
11000111
11000111
11000111
11000111
11000111
11000111
11000111
11000111
11000111
11000111
11000111
11000111
11000111
11000111
11000111
11000111
11000111
11000111
11000111
11000111
11000111
11000111
11000111
11000111
11000111
11000111
11000111
11000111
11000111
11000111
11000111
11000111
11030111
10000001
11111111
