1111111111111111
1000000000000001
1000000000000001
1000000000000001
1000000000000001
1000010010010001
1000010010010001
1000010010010001
1000010010010001
1000010010010001
1000010010010001
1000010010010001
1000010010010001
1000011111110001
1000000000000001
1111111111111111
