1111111111111111
1000000000000001
1000000000000001
1000000200000001
1000000000000001
1000000000000001
1000000030000001
1000000000000001
1000000000000001
1000000000000001
1000000000000001
1000000000000001
1000000000003001
1000300000000001
1000000000000001
1111111111111111
