1111111111111111
1000000000000001
1000000000000001
1000000200000001
1000000000000001
1000000000000001
1000000070000001
1000000000000001
1000000000000001
1000000000000001
1000000000000001
1000000000000001
1000000000008001
1009000000000001
1000000000000001
1111111111111111
