1111111111111111111111
1000000000000000000001
1000060010000100600001
1000000010000100000001
1010111110000111110101
1010000000000000000101
1010000000000000000101
1010000000000000000101
1010000000000000000101
1010000000000000000101
1010000000000000000101
1010000002000000000001
1010000000000000000101
1010000000000000000101
1010000000000000000101
1010000000000000000101
1010000000000000000101
1010000000000000000101
1010111110000111110101
1000000010000100000001
1000060010000100600001
1000000000000000000001
1111111111111111111111
