111111111
100000001
100000001
100020001
100000001
100000001
100000001
100000001
100801111
100000071
100000701
100000001
111111111
