111111111
100000001
100000001
100020001
100000001
100000001
100000001
100000001
100800001
100000001
100000701
100000001
111111111
