111111111
100000001
100000001
100020001
100000001
100000001
100000001
100000001
100001111
100000001
100000001
100000001
111111111
