1111111111
1000000001
1004000301
1000000001
1011111111
1000000001
1020000001
1000005001
1006000001
1000000001
1111111111